Ингредиенты

см. образцы в папке ingredients

tortilla - лепешки тортилья из пшеницы (цвет, близкий к белому)
tortilla-chips - чипсы из кукурузной тортильи (желтые, треугольные)
chili-pepper - перец
tomato - помидоры
pork - свинина (ну или говядина - главное, чтобы от птичего мяса отличалась по виду)
bean - фасоль красная
avocado - авокадо
cheese - сыр желтый, лучше с большими дырками
onion - лук репка
lime - лайм
sour-cream - сметана, в какой-нибудь посудинке


Рецепты 

см. образцы в папке recipes

chili-con-carne - горячее блюдо из чили с мясом, томатами и бобами
ceviche - севиче, холодная закуска из морепродуктов
assorted-empanadas - пирожки, важно соблюдать классическую форму, как на картинке
grilled-shrimps - шашлычок из креветок
football-fan-nachos - "начос футбольного фаната", блюдо из чипсов с  мясом
burrito - буррито, рулетик из тортильи с начинкой
quesadilla - кесадия, обжаренный сандвич из тортильи с начинкой
fajitas - блюдо из птицы и овощей
stuffed-tacos - такос с начинкой. такос - это согнутая пополам небольшая жареная лепешка
bean-soup - фасолевый суп, с оттенком красного
tortilla-soup - суп с тортильями (тортильи сервируются или кладутся прямо в суп)
tex-mex-tuna - рыба в гриле
chimichanga - вариант обжаренного буррито
chicken-chilaquiles - блюдо из курицы с зеленым перцем
caldo-de-pollo - суп из курицы с фасолью



